#,#,#,#,#,#,#,#,#
#,#,.,P,G,G,G,#,#
#,#,.,.,.,#,#,#,#
#,#,#,B,.,.,.,.,#
#,.,.,.,#,B,#,.,#
#,.,B,.,#,.,.,.,#
#,.,.,.,#,#,#,#,#
#,#,#,#,#,,,,
