,,W,W,W,W,W,
,,W,,,,W,
W,W,W,C,W,,W,W
W,,,,,C,,W
W,,W,,,W,,W
W,,C,,Q,,,W
W,W,,,W,B,W,W
,W,W,,,,W,
,,W,W,W,W,W,
