,,W,W,W,W,W,
W,W,W,,,,W,
W,,,C,W,,W,W
W,,W,,,C,,W
W,,C,,,W,,W
W,W,,W,Q,,,W
,W,,,,B,W,W
,W,W,W,,,W,
,,,W,W,W,W,
