,W,W,W,W,W,,
,W,,,,W,W,W
W,W,,W,B,,P,W
W,,G,,B,,,W
W,G,G,G,W,B,W,W
W,,W,,,B,,W
W,,,W,,,,W
W,W,,,,W,W,W
,W,W,W,W,W,,
